11111111
10000C01
10C00001
10P000E1
10000001
11111111
