111111
1E0001
100001
100C01
1PC001
111111