1111111111111111111111111111111111
1E0000000000000C00000C000000000001
1010010100100000101001000000101011
1010010010101010001001000000101011
1P0000000C00C00000000X0000000000C1
1111111111111111111111111111111111